2SS=Secondary Superstat
AM=Accelerated Metabolism advantage
Andrithal=Vikorin's Lair on Monster Island
AoAC=Aura of Arcane Clarity
Aoe=Area of Effect
AoED=Aura of ebon destruction
AoED=Aura of Ebon Destruction
AoPM=Aura of Primal Majesty
AoPM=Aura of Primal Majesty
AoRP=Aura of Radiant Protection
AP=Adventure Pack
AS=Aftershock, a comic strip featuring viper and qliphoth
BM=Blood Moon
CC=Crippling Challenge advantage, or crowd control
CoAP=Circle of Arcane Power
Conc=Concentration
CoPD=Circle of Primal Dominion
CoS=Congress of Selves
CS=Challenging Strikes advantage
CS=Comic Strip- interchangeable with AP for simplicity
DE=Devour Essence
DF=an adventure pack featuring qliphoth
DPS=Damage Per Second
EB=Energy Builder
EU=Energy Unlock
F and I=Fire and Ice
F&I=Fire and Ice
FotM=Form of the Master
FotT=Form of the Tempest
GCR=Gold Champion Reocgnition
G=Globals aka Gold
Hex=Hex of Suffering
HoS=Hex of Suffering
Invuln=Invulnerability
JG=Justice Gear
KM=Kinetic Manipulation
LA=Lightning Arc
LI=Lemurian Invasion
L=Locals aka Bronze
LR=Lightning Reflexes
LT=Lead Tempest
MC=Millennium City zone
MI=Monster Island
MSA=Molecular Self-Assembly
MS=Mental Storm
N=Nationals aka Silver
OSV=Onslaught Supervillain
OV=Onslaught Supervillain
PBAOE=point blank area of effect
PFF=Personal Force Field
PSS=Primary Superstat
SCR=Silver Champion Recognition
SC=Sky Command
SL=Serpent Lantern
SoD=Shadow of Doubt
SR=Sniper rifle or strafing run
SSS=Secondary Superstat
Stormb=Stormbringer
TA=Teleios Ascendant
TC=Targeting Computer
TGM=Two Gun Mojo
TP=Travel Power, or Teleportation, or teleport device
TT=Therakiels Temple
Unlock=Energy Unlock
Unstop=Unstoppable
UR=Unleashed Rage
VB=Vibora Bay zone
WoTW=Way of the Warrior
WO=Whiteout
